1111111111111111111
111111P011111111111
1111110111111111111
1000100000100001001
100000000M000000001
1100001000001000001
1000111P11100000001
1111111111111001111
1111111111111E11111
1111111111111111111